Mm, Mm, Mm, Gg, Gll^Fp, Gg, Gll^Fp, Gg, Gll^Fp, Gg, Wo, Wwg, Wwg, Gg, Mm, Gg, Mm, Gg, Mm, Gg, Gg^Es, Gg, Gg^Es, Gg^Es, Gg^Es, Gg^Es, Gg^Es, Gg, Gg^Es, Gg, Gg^Es, Gg^Es, Hh, Hh, Hh, Hh, Hh, Hh, Hh, Hh, Hh, Mm, Mm, Gg, Gll^Fp, Gg, Gll^Fp, Gg, Gg, Gg, Gg
Mm, Mm, Mm, Gll^Fp, Gs, Gll^Fp, Gg, Gll^Fp, Gg, Gll^Fp, Wo, Wwg^Edb, Wwg, Ds, Gg, Mm, Mm, Mm, Mm, Gg^Es, Gg, Gg^Es, Gg, Gg^Es, Gg, Gg, Gg, Gg^Es, Rb^Gvs, Rb^Gvs, Rb^Gvs, Gg, Gg, Gg, Gg, Gg, Gg, Gg, Gg, Gg, Gg, Mm, Mm, Mm, Mm, Mm, Mm, Gll^Fp, Mm, Gg, Gg
Mm, Mm, Gll^Fp, Mm, Gg, Gs^Vc, Gg, Gg, Wo, Wo, Wwg, Wwg, Ds, Ds, Gg, Mm, Mm, Mm, Gg, Gg, Gg, Gg^Es, Gg, Gg, Gg, Gg, Gs, Rb^Gvs, Rb^Gvs, Rb^Gvs, Gs, Gg, Rb^Gvs, Gg, Gg, Gg, Gg, Gg, Gg, Gg, Gg, Gg, Gg, Hh, Hh^Vhh, Mm, Mm, Mm, Ms, Mm, Gg
Mm, Mm, Gll^Fp, Mm, Gg, Gg, Gs^Fds, Gg, Wo, Wwg, Wwg, Wwg, Ds, Gg, Gg, Gg, Gg, Mm, Gg, Gg^Es, Gs^Vc, Gg^Es, Gg, Gg, Gg, Gs, Gs, Re, Re, Re, Rb^Gvs, Rb^Gvs, Rb^Gvs, Rb^Gvs, Gg, Gg, Gg, Gg, Gg, Gg, Gg, Gg, Gg^Fet, Gg, Gg, Gg, Mm, Mm, Ms, Ms, Ms
Mm, Gg, Gll^Fp, Gg, Gg, Gs^Fms, Gs^Fms, Gs^Fds, Wo, Wo, Wo, Ds, Re, Gs, Gs, Gg, Gg, Gg, Gg^Es, Gg^Es, Gg, Gg, Gg, Gg, Gg, Gg, Re, Re, Re, Re, Re, Rb^Gvs, Gs, Gg, Gg, Gg, Gg, Gg, Gg, Gg, Gg, Gg, Gg, Gg, Gg, Gg, Hh, Mm, Mm, Ms, Ms
Gg, Gll^Fp, Gg, Gg, Gs^Fms, Gs^Fms, Gs^Fms, Wo, Gs^Fds, Wo, Wo, Wwg, Wwg, Re, Gs, Gs, Gs, Gs, Gs^Es, Gg, Gg, Gg, Gg, Gg, Gg, Gg, Rp, Rp, Ce, Ce, Ke, Re, Gg, Gg, Gg, Gg, Gg, Gs^Fds, Gs^Fds, Gg, Gg, Gg, Gg, Gg, Gg, Gg, Gg, Hh, Hh, Mm, Mm
Gg, Gs^Vc, Gg, Gg, Gs^Fds, Gs^Fms, Gg^Fet, Gs^Fds, Gs, Re, Wo, Wwg, Wwg, Rb, Gg, Gs, Gg, Gs, Gg, Gs, Gs, Gs, Gs, Gg, Gg, Rp, Gg, Gg, Gg, Ce, Ce, Ce, Gs^Fms, Gs^Fms, Gs^Fms, Gg^Fet, Gs^Fds, Gll^Fp, Gs^Fds, Gs^Fms, Gs^Fds, Gg, Gg, Gg, Gg, Gg, Gs^Vh, Gg, Gg, Hh, Mm
Gg, Gg, Gg, Gs^Fms, Ds, Gg, Gg, Gs, Re, Re, Wwg, Wwg, Wwg, Gg, Gg, Gg, Gg, Gg, Gg, Gs, Gs, Gg, Gg, Gg, Rp, Rp^Esd, Gg, Gg, Gg, Gg, Gg, Ce, Gs^Fms, Gs^Fms, Gs^Fds, Gll^Fp, Gs^Fds, Gll^Fp, Gg^Fet, Gs^Fms, Gs^Fms, Gg, Gg, Gs^Vh, Gg, Re, Re, Gg, Gg, Gg, Mm
Gg, Gg, Ds, Ds, Wwg, Wwg, Wwg, Cer, Wo^Bw\, Wo, Gg, Wwg, Gg, Gg^Efm, Gg, Mm, Gg, Gg, Gg, Gg, Gs, Gs, Re, Rp, Gg, Gg, Gg, Gg, Gs^Fms, Gg, Gs^Fms, Gg, Gs^Fds, Gs^Fds, Gll^Fp, Gs^Fds, Gg, Gg, Gll, Gg, Gll, Gg, Gg, Gg^Edt, Re, Re, Gg, Gg, Gg, Gg, Mm
Ds, Ds, Wwg, Wwg, Wo, Wwg, Wo, Wo, Gg, Re, Re, Gg, Gg, Gg, Gg, Gg, Gg, Gg, Re, Gs, Gd, Re, Gg, Gd, Gg, Gg, Gs^Fds, Gs^Fds, Gs^Fds, Gs^Fms, Gg, Gs^Fds, Gg, Gg^Fet, Gs^Fms, Gs^Fms, Gs^Fms, Gg, Gll, Gll, Gg, Gg, Gll, Gg, Gg, Gg, Gg, Hh, Mm, Mm, Mm
Wwg, Wwg, Wwg, Wo, Wo, Wo, Wwg, Wwg, Gg, Gg, Gg, Re, Re, Gg, Gs^Vc, Gg, Re, Re, Gd, Gd, Gg, Gg, Gg, Gg, Gg, Gg, Gs^Fds, Gs^Fms, Gs^Fds, Gs^Fds, Gs^Fms, Gg, Gg, Gs^Fds, Gs^Fms, Gs^Fms, Gg, Gg, Gg^Es, Gg, Gg, Gg, Gg, Gg, Gg, Gg, Gg, Hh, Gg, Mm, Mm
Wwg, Wwg, Wo, Wo, Wo, Wwg, Wwg, Gg^Es, Gg^Es, Gg, Gg^Es, Gg, Gg^Es, Re, Wo, Gg, Gg, Gg, Gg, Gg, Gg, Gg, Gg, Gg, Gg, Gs^Fms, Gs^Fms, Gs^Fds, Gs^Fds, Gg, Gg, Gg, Gg, Gs^Fds, Gg, Gg, Gg, Gg, Gg, Gg, Gg, Gg, Gg, Gg, Gg, Gg, Gg, Gg, Gg, Mm, Mm
Ds, Wwg, Wwg, Wo, Wo, Wo, Wo, Wwg, Wwg, Gg^Es, Wwg, Gg^Es, Wo, Wo, Wo, Wwg, Gg, Gs^Fds, Gs^Fds, Gg, Gg, Gg, Gg, Gg, Gg, Gg, Gs^Fms, Gs^Fms, Gg^Efm, Gg^Efm, Gg^Efm, Gs^Vc, Gg, Gg, Gg, Gg, Gg, Gg, Gg, Gg, Gs^Fms, Gg, Gs^Fds, Gg, Gs^Fds, Gs^Fds, Gs^Fds, Gg, Gg^Es, Mm, Mm
Gg, Ds, Ds, Ds, Ds, Wo, Wo, Wo, Wo, Wwg, Wwg, Wo, Wo, Wo^Edt, Wo, Wwg, Ww^Ewf, Gs^Fds, Gg^Fet, Gs^Fds, Gs^Fds, Gg, Gg, Gg, Gg, Gs^Fms, Gg, Gg, Gs, Gs, Gs, Gg, Rp, Gg, Gg, Gg, Gg, Gg, Gll, Gg, Gs^Fds, Gs^Fds, Gg, Gg, Gs^Fds, Gs^Fds, Gg^Qhuf, Gs^Fds, Gs^Fds, Gg^Es, Mm^Es
Gs^Fms, Gs^Fds, Gs^Fds, Gg, Gg, Ds, Wwg, Wo, Wo, Wo, Wo, Wo, Wo, Wo, Wwg, Wwg, Ww^Ewl, Ww^Ewf, Gs^Fds, Gs^Fds, Gg, Gg, Gs, Rp, Rp, Gg, Gg, Gg, Gg, Gs, Rp, Rp, Gg, Gg, Gg, Gg, Gg, Gll^Edb, Gg, Gll, Gg, Gg, Gg, Gs^Fds, Gg^Qhuf, Gg^Qhuf, Gg^Qhuf, Gg^Qhuf, Gg^Qhuf, Gs^Fms, Gs^Fms
Gs^Fms, Gs^Fds, Gll^Fp, Gs^Fds, Gs^Fds, Gs^Fds, Gs^Fds, Wwg, Wwg, Wo^Edb, Wo, Wo, Ds^Es, Ds^Es, Ds^Es, Ww^Ewf, Gg, Gs^Fds, Gs^Fds, Gg, Gs, Gs, Gs, Gg, Gg, Rp, Rp, Gs, Gs, Gs, Rp, Rp, Gg, Gg, Gg, Gg, Gll, Gll, Gg, Gg, Gg, Gg, Gg, Gs^Fds, Gs, Gg^Qhuf, Gg^Qhuf, Gg^Qhuf, Gg^Qhu, Gg^Qhu, Gg^Qhu
Gll^Fp, Gs^Fms, Gs^Fms, Gs^Fds, Gs^Fds, Gs^Fds, Gs^Fds, Gg, Ds, Wwg, Wwg, Wo, Ds^Es, Gg, Gg^Efm, Gg, Gg, Gg, Gs, Gg, Gs^Efm, Gs, Gg, Gg, Gg, Gg, Gg, Rp, Rp, Rp, Gg, Gg, Gg, Gg, Gg, Gg, Gg, Gg, Gg, Gg, Gg, Gg, Gg, Gg, Gs, Rb, Rb, Gg^Qhuf, Gg^Qhuf, Gg^Qhu, Gg^Qhu
Gll^Fp, Gg^Fet, Gll^Fp, Gs^Fms, Gs^Fms, Gs^Fds, Gs^Fds, Gg, Gg, Ds^Es, Wwf^Es, Wwf, Ds^Es, Gg, Gg^Efm, Gg^Efm, Gg^Efm, Gg, Gg, Gs, Gg, Gg, Gg, Gg, Gg, Hh, Hh, Gg, Gg, Rp, Gs^Vh, Gg, Re^Gvs, Gg, Gg, Gg, Gg, Gg, Gd, Gd, Gg, Gg, Gg, Gg^Wm, Gg, Gs, Gs, Gg^Qhuf, Gg^Qhuf, Gg^Qhuf, Gg^Qhu
Gll^Fp, Gll^Fp, Gll^Fp, Gs^Fms, Gll^Fp, Gs^Fms, Gs^Fds, Gs^Fds, Gs^Fds, Ds, Ds^Es, Wwf^Es, Wo, Ds^Es, Ds^Es, Gg, Gg, Gg, Gg, Gg, Gs^Fds, Gs^Fds, Gs^Fds, Gs^Fds, Mm, Mm, Mm, Gg, Gg, Gg, Re^Gvs, Re^Gvs, Re^Gvs, Re^Gvs, Gg, Gg, Gg, Gg, Gg, Gd, Gs^Vh, Gs^Eff, Gs^Eff, Gg, Gg^Efm, Gg^Wm, Gs, Rb, Rb, Gg^Qhuf, Gg^Qhu
Gll^Fp, Gll^Fp, Gll^Fp, Gll^Fp, Gs^Fms, Gs^Fms, Gs^Fds, Gs^Fds, Gg, Gg, Ds, Wo, Wo, Wo, Ds, Ds, Gg, Gg, Gs^Fds, Gs^Fds, Gs^Fds, Gs^Fds, Gs^Fds, Gs^Fds, Gs^Fds, Mm, Mm, Gg, Re^Gvs, Gg, Gg, Re^Gvs, Gg, Gg, Re^Gvs, Re^Gvs, Re^Gvs, Gg, Gg, Gg^Eff, Gg^Eff, Gg^Eff, Gg, Gg, Gg, Gg^Efm, Rb, Rb, Gg^Qhuf, Gll^Qhu, Gg^Qhu
Gll^Fp, Gll^Fp, Gll^Fp, Gll^Fp, Gs^Fms, Gll^Fp, Gg, Gs^Fds, Gg, Gg, Gg, Ds, Wo, Wo, Ds, Gg, Gg, Gg, Gg, Gs^Fds, Gg, Gs^Fds, Gg, Gs^Fds, Gg, Gg, Gg, Re^Gvs, Re^Gvs, Re^Gvs, Gg, Gg, Gg, Re^Gvs, Re^Gvs, Re^Gvs, Gg, Gg, Gg, Gg, Gg, Gg, Gg, Gg, Gg, Gg, Gg^Qhuf, Gg^Qhuf, Gg^Qhuf, Gg^Qhuf, Gg^Qhuf
